63
43
110000111111110000001111011011111100000000001100111100000111000
110000111110000000000011011011111100000000001100011110000111000
110000111110000010110001011011111001000000000100011110000111000
110000111100001011111001000011111001000110011110000110000011000
110000111100011001111000000000000000000110011110000111000001001
110000111100011001111000000000000000001011010110000000000001101
000000001100000010011000000011111000000011010110000000000001101
000000000000000000000000000011111000000000100000010000000000011
110000001100111000000000000001111000000000100000111000001000111
110000000100111100000000000001111000000000000000111000001100011
110000000000111100000000000001111100000000000000011000001110000
110000000001001100000000001101111100000000000000011111001110000
110000000000000000001000101100111100000000000000000001011110000
000001110010000000011100100000111110000000000000011011111110011
000001110011000000011100000010111100000000000000001011111111111
111011110011000000000000011010111110000000000000001111001001101
111111110000000000000100011011111111110000000000000000000000000
111111110000010000000001100001111111111110000000000011000000000
111111110110000000000001000001110011111111111100111111111111111
000000000000001100000000000000001101111111111100111111111111111
000000000000001100000000000000001100011111111100111111110000011
000000000000000100011111000000000000000000001100111111110000000
111111110000111100011111000000000000000000000000000000000000000
111111111111111100011110000000000000000000000000000000000111111
111111111111111100011110000000000000000000000111010000011111111
000000001111111100000000000000000000000000000001000000111100000
000000000000001100000000000000000000000000000000000000111100000
000000000000000000000000000000000000000000000000000011000000000
000000000000011100000001111100000000000000000001100111000000000
000000000000011100000001111100000000000000000011101111000000000
000000000000111100000111111100100000000000000011101111000000001
000000000000111100000111000100110001111000000011100111000000001
000000000100000000000110000000000011111001000000000111000000001
000000000100000000000000000011000011111001100000000000000000011
000000000100000000000000000011000011111000000000000100000000011
000000000100001111110000000001010011111111000000000100000000011
000000000111000000010110000000111011111111100000000100000000011
000000000111100000000110000000111000111111100001001101101111010
000000000111100110000011000000000000111111100001000101111111101
000000000000111111000011100000000000001111100000001100011110001
000000000000011111001011000100000001000111100000000000111110001
000000000000011111100000001110000001000000000000000000000110011
000000000000011000111111000100000000010000000000000000000000011
